# -*- conf -*-
# width
8
# height
12
# number of maps
7
# map1
00000000
00000000
00000000
00000000
11000011
11000011
11000011
11000011
00000000
00000000
00000000
00000000
# map2
00000000
00000000
00000000
00000000
00111100
00111100
00111100
00111100
00000000
00000000
00000000
00000000
# map3
11000011
11000011
00000000
00000000
00000000
00000000
00000000
00000000
00000000
10000001
11000011
11100111
# map4
00000000
00000000
00000000
00000000
00000000
00000000
00000000
00000000
00000000
00000000
11000011
00000000
# map5
11000011
11000011
00000000
00000000
00000000
00000000
00000000
00000000
11000001
11000001
11100011
11110111
# map6
01000010
01000010
00000000
00000000
00000000
00011000
00011000
00000000
00000000
00000000
11000011
00000000
# map7
10000100
10000100
10000110
00000000
00000000
00000000
00000000
00000000
00000000
00000000
11011011
11011011
